20 15
274 831

141 138 138 138 138 138 142 35 35 87 73 85 86 35 136 15 143 132 132 133
136 35 35 35 35 35 137 138 138 138 146 146 146 138 139 15 15 15 15 136
136 35 35 35 35 35 35 35 35 35 84 85 86 35 35 15 15 15 15 136
136 35 35 35 35 35 35 35 35 35 84 85 86 35 35 15 15 15 15 136
136 35 35 35 35 35 35 35 35 81 79 71 89 35 35 15 15 15 15 136
136 35 35 35 35 35 35 35 35 87 88 89 35 35 35 15 15 15 15 136
136 35 35 35 35 35 35 35 35 35 35 35 35 35 35 15 15 15 15 136
136 35 35 35 35 35 35 35 35 81 82 83 35 35 35 15 15 15 15 136
136 35 35 35 35 35 35 35 35 84 85 77 83 35 35 15 15 15 15 136
136 35 35 35 35 35 35 35 35 87 73 85 86 35 35 15 15 15 15 136
136 35 35 35 35 35 35 35 35 35 84 71 89 35 35 15 15 15 15 136
136 35 35 35 35 35 35 35 35 81 79 86 35 35 35 15 15 15 15 136
136 35 35 35 35 35 35 35 35 84 71 89 35 35 35 15 15 15 15 136
136 35 35 35 35 35 35 35 81 79 86 35 35 35 35 15 15 15 15 136
143 132 132 133 21 22 22 23 84 85 86 141 138 138 138 138 138 138 138 139