50 15
500 550

15 87 88 73 85 85 85 85 85 85 85 85 85 85 85 85 85 85 85 85 71 72 89 15 15 15 15 15 15 15 15 15 15 15 15 15 15 15 15 15 15 15 15 15 15 15 15 15 15 15
15 15 15 87 88 88 73 85 85 85 85 85 85 85 85 85 85 85 85 85 74 15 15 15 15 15 15 15 15 15 15 15 15 15 15 15 15 141 138 138 138 138 138 142 15 141 138 138 138 138
15 15 15 15 15 15 87 88 73 85 85 85 85 85 85 85 85 85 71 72 89 15 15 15 15 15 15 15 15 15 15 15 15 15 15 15 15 136 15 15 15 15 15 137 138 139 15 15 15 15
15 15 15 15 15 15 15 15 87 88 73 85 85 85 85 85 85 71 89 15 15 15 15 15 15 15 15 15 15 15 15 15 15 15 15 15 15 136 15 15 15 15 15 15 15 15 15 15 15 15
15 15 15 15 15 15 15 15 15 15 76 85 85 85 85 71 72 89 15 15 15 15 15 15 15 15 15 15 15 15 141 138 138 138 145 138 138 139 15 15 15 131 132 132 132 133 15 15 15 15
15 15 15 15 15 15 15 15 15 81 79 85 71 72 72 89 15 15 15 15 15 15 15 15 15 15 15 15 15 15 136 15 15 15 34 15 15 15 15 15 15 134 15 15 15 136 15 15 15 15
138 138 142 15 15 15 15 15 15 76 85 71 89 15 15 15 15 15 15 15 15 141 138 138 138 138 138 138 138 138 139 15 15 15 34 15 15 15 15 15 15 137 138 145 138 139 15 15 15 15
15 15 137 138 138 138 138 138 138 146 146 146 142 15 15 15 15 15 15 15 141 139 15 15 15 15 15 15 15 15 15 15 15 15 34 15 15 15 15 15 15 15 15 15 15 15 15 15 15 15
15 15 15 15 15 15 15 15 15 84 85 86 137 138 138 138 138 138 138 138 139 15 15 15 15 15 15 15 15 15 15 15 15 15 34 15 15 15 15 15 15 15 15 15 15 15 15 15 15 15
15 15 15 15 15 15 15 15 15 84 85 86 15 15 15 15 15 15 15 15 15 15 15 15 15 15 15 15 15 15 15 15 15 15 34 15 15 15 15 15 15 15 15 15 15 15 15 15 15 15
15 15 15 15 15 15 15 15 15 84 85 86 15 15 15 15 15 15 15 15 15 15 15 15 15 15 15 15 15 15 15 15 21 22 68 22 22 22 22 22 22 22 23 15 15 15 15 15  15 15
15 15 15 15 15 15 15 15 81 79 71 89 15 15 15 15 15 15 15 15 15 15 15 15 15 15 15 15 15 21 22 22 19 25 25 25 25 25 25 25 25 25 17 22 23 15 15 15 15 15
15 15 15 15 15 15 15 15 84 85 86 15 15 15 15 15 15 15 15 15 15 15 15 15 15 15 15 21 22 19 25 25 11 12 12 12 12 12 12 12 12 13 25 25 17 18 23 15 15 15
15 15 15 15 15 15 15 15 84 85 86 15 15 15 15 15 15 15 15 15 15 15 15 15 15 15 21 19 11 12 12 12 29 15 15 15 15 15 15 15 15 27 13 25 25 25 17 18 18 18
15 15 15 15 15 15 15 15 87 73 77 78 83 15 15 15 15 15 15 15 15 15 15 15 21 22 19 25 26 15 15 15 15 15 15 15 15 15 15 15 15 15 27 28 28 28 13 25 25 25


