28 20
335 895

133 24 25 26 137 138 138 138 138 146 138 138 138 138 138 138 138 138 138 138 138 138 138 138 138 138 142 15
136 27 62 29 132 133 31 32 32 32 32 32 32 32 32 32 32 32 42 32 32 32 32 32 41 15 136 15
143 133 34 134 15 136 34 81 82 82 82 82 83 15 15 15 15 15 34 15 15 15 15 15 15 15 137 138
15 136 34 134 15 136 34 76 85 85 71 122 89 15 15 15 15 15 34 141 139 81 82 82 82 82 82 82
15 136 34 134 15 136 34 76 85 85 74 97 92 92 92 92 93 141 145 139 15 84 85 85 85 85 85 85
15 136 34 134 15 136 34 76 85 85 74 15 15 15 15 141 146 139 37 32 33 84 85 85 85 85 85 85
15 136 34 134 15 136 34 76 85 85 74 137 142 15 15 136 94 15 15 15 34 84 85 85 85 85 85 85
15 136 34 134 15 136 34 76 85 85 77 83 134 15 15 136 97 92 92 93 34 84 85 85 85 85 85 85
15 136 34 137 145 139 34 87 88 88 88 89 137 138 145 139 15 15 15 94 34 84 85 85 85 85 85 85
15 136 37 32 32 32 46 15 15 15 15 15 15 15 15 15 15 31 41 94 34 84 85 85 85 85 85 85
15 136 15 15 15 15 37 32 32 32 32 32 32 32 32 32 32 39 15 94 34 84 85 85 85 85 85 85
138 139 15 15 15 15 15 81 82 82 82 82 82 83 15 15 15 15 91 99 34 84 85 85 85 85 85 85
15 15 131 132 132 132 133 84 71 88 88 88 88 116 92 92 92 92 99 15 34 87 88 88 88 88 88 88
15 15 134 15 15 15 136 84 74 15 47 32 32 32 32 42 32 32 32 32 48 32 32 32 33 131 132 132
15 15 134 15 15 15 136 84 74 15 15 15 15 15 15 34 131 132 132 132 132 132 133 15 34 134 15 15
136 15 137 138 145 138 139 84 77 78 78 78 78 83 15 34 134 15 15 15 15 15 136 15 34 134 15 15
136 15 15 15 34 15 15 87 88 88 88 88 88 89 15 34 134 15 15 15 15 15 136 15 34 134 15 15
136 15 15 15 34 15 15 15 15 15 15 15 15 15 15 34 134 15 15 15 141 145 139 15 34 134 15 15
136 15 15 15 37 32 32 32 32 32 32 32 32 32 32 39 134 15 15 15 136 37 32 32 39 134 15 15
143 132 132 132 132 132 132 132 132 132 132 132 132 132 132 132 137 138 138 138 139 81 82 82 83 137 138 138





